++++++++++++++++++++++
+ +    ++   +      +  
+ +++++ +++++ + ++ + +
+ ++                 +
+ ++++ +++++++++ + +++
+    +      +     + ++
++++ + ++++ ++++++ +++
+    +    +       + ++
+ ++++++ + ++++++ + ++
+      ++   +    S + +
++++++++++++++++++++++